111111111
100000C01
10P000001
100001E01
10C001001
111111111