111111111
100000C01
10P000001
100000E01
10C000001
111111111